................
................
..############..
..############..
..##............
..##............
..##..####..####
..##..####..####
..............##
..##..........##
..##...#..X...##
..##...#......##
..##..##########
..##............
................
..##............
