................
.####.....#.#...
....##.#..#.##..
.#.....#.##...#.
.#.#........#.#.
.#.##########...
..#....#.....#..
.#..##.#...O..#.
...#.#.X.####...
.....#....#...#.
..O...###..#..#.
........#..#.#..
.....#.##.#..#..
....#.....#.....
....#.####..#...
....#...........
