........
.#.####.
........
.####.##
...#...#
.#.#.X.#
.#.#####
.#......

