........
.######.
.#......
.#.##.##
...#...#
.#O#.X.#
.#.#####
.#......
