........
.#.####.
...#....
.####.##
...#...#
.#...X.#
.#.#####
.#......
