..........
.#.###.##.
.#...#..#.
.########.
.#........
##.#######
....#..#..
.##...#.#.
..#.#.....
#......#..