..........
.#.###.##.
.#...#..#.
.########.
.#........
##.#######
....#..#X.
.##...#.#.
..#.#.....
#......#..