..........
.#.###.###
.#..#.....
.#.###.##.
.#.....#..
.#.###.###
.#..#X...#
.#.###.#.#
.#........
.....#....
