........
........
...O.O..
........
........
.....X..
..O.....
........
