................................
................................
..########.........###.###......
..#########........###.###......
.........####..###..##..####....
.........####..##...###.####....
..##...........##...###......##.
..##...........####.####.....##.
..##..##................###.##..
..##..##................###.##..
..##..#####################.....
..##..######################....
....##........##...........##...
....##........##...........##...
..##....####..##.......O....##..
..##....####..##............##..
......##..##......#########.....
......##..##..X...#########.....
...........##........##......##.
...........##........##......##.
.....O......######....##....##..
............######....##....##..
................##....##..##....
................##....##..##....
...........##..####..##...##....
...........##..####..##...##....
........##..........##..........
........##..........##..........
........##..########....##......
........##..########....##......
........##......................
........##......................
