........
.#.####.
...#....
.####.##
.O.#...#
.....X.#
.#.#####
.#......
