................
.####.....#.#...
....##.#..#.##..
.#.....#.##...#.
.#.#........#.#.
.#.##########...
..#....#.....#..
.#..##.#......#.
...#.#...####...
.....#....#...#.
......###..#..#.
........#..#.#..
.....#.##.#..#..
....#.....#.....
....#.####..#...
....#...........
